VVVVVVVVVVVVVVVVVVVV
V                  V
V S                V
V                  V
V                  V
V                  V
V                  V
V                  V
V                  V
V                  V
V                E V
V                  V
VVVVVVVVVVVVVVVVVVVV