VVVVVVVVVVVVVVVVVVVV
VVVVV    S     VVVVV
VVVV            VVVV
VVV              VVV
VV                VV
VVV              VVV
VVVV            VVVV
VVVVV          VVVVV
VVVVVV        VVVVVV
VVVVVVV      VVVVVVV
VVVVVVVVV   VVVVVVVV
VVVVVVVVVVEVVVVVVVVV
VVVVVVVVVVVVVVVVVVVV