VVVVVVVVVVVVVVVVVVVV
VE                EV
VVVVVV        VVVVVV
VE V            V EV
V  V      V     V  V
V  V            V  V
V  VVV    S   VVV  V
V                  V
V V      VVV     V V
V V              V V
V V VV VVVVVV VV V V
VEV       E      VEV
VVVVVVVVVVVVVVVVVVVV