VVVVVVVVVVVVVVVVVVVV
VS        V        V
V         V        V
V         V        V
V                  V
V                  V
V                  V
V                  V
V         V        V
V         V        V
V         V        V
V         V       EV
VVVVVVVVVVVVVVVVVVVV